...###.....
..##.#.####
.##..###..#
##........#
#...@..#..#
###..###..#
..#..#....#
.##.##...##
.#......##.
.#.....##..
.#######...
